20,35.
00000000000000000000000000000000000
00000000000000000000000000000000000
00000000000000000000000000000000000
00000000000000000000000000000000000
GGGGGGGGGG0000000000000000000000000
GGGGGGGGGG0000000000000000000000000
GGGGGGGGGG0000000000000000000000000
GGGGGGGGGG0000000000000000000000000
GGGGGGGGGG0000000000000000000000000
GGGGGGGGGG0000000000000000000000000
00000000000000000000000000000000000
0000GG0G0G0G0G000000000000000000000
00000G00000000000000000000000000000
000000000G0000000000000000000000000
00000000000000000000000000000000000
00000G00000000G00000000000000000000
000P0000000000000000000000000000000
00000000000000000000000000000000000
00000E000G0000000000000000000000000
0GGGGGGGGGGGGGGGGGGG000000000000000